C 255,255,254
NO ./assets/wall2.png  
SO ./assets/sand.png
WE ./assets/sand.png
EA ./assets/sand.png 

F 50,50,50

11111111111111
11110000000011
10000000000011
10000N00000011
10110000111011
11111111111111