C 255,255,254

NO ./assets/wall2.png
SO ./assets/sand.png
WE ./assets/nebula.png
EA ./assets/green.png 

F 50,50,50

11111111111111
11110000000001
10010000000001
1000000S000011
10110000111011
11111111111111