C 0,100,255

NO ./assets/wall2.png
SO ./assets/sand.png
WE ./assets/nebula.png
EA ./assets/green.png 

F 150,255,150

11111111111111
11110000000001
10010000000001
1000W000000011
10110000111011
11111111111111