C 255,255,254
NO ./assets/Solid_blue.png
SO ./assets/Solid_green.png
WE ./assets/wall2.png
EA ./assets/Solid_yellow.png

F 50,50,50

11111111111111
10000011100001
10000011100011
10N00000000001
10000001100001
11111111111111