C 255,255,254
NO ./assets/m.xpm  
SO ./assets/brick.xpm
WE ./assets/m.xpm
EA ./assets/ceiling.xpm

F 50,50,50

111111111111111
100100000010001
100000000000001
100000000000001
1000N0000000001
111111111111111