C 255,255,254
NO ./assets/Solid_blue.png
SO ./assets/Solid_green.png
WE ./assets/wall2.png
EA ./assets/Solid_yellow.png

F 50,50,50

1111111111111111111111111
1000000000110000000000001
1011000001110000000000001
100100000000000000E000001
1111111110110000011100001
1000000000110000011101111
1111011111111101110000001
1111011111111101110101001
1100000011010101110000001
1000000000000000110000001
1000000000000000110101001
1100000111010101111101111
1111011111101011110111101
1111111111111111111111111